ALL	AO L
BLUE	B L UW
BRIGHTESS	B R AY T AH S
BRIGHTNESS	B R AY T N AH S
COLOR	K AH L ER
COLOR(2)	K AO L ER
DOWN	D AW N
GREEN	G R IY N
HIGH	HH AY
LIGHT	L AY T
LIGHTS	L AY T S
LOW	L OW
MEDIUM	M IY D IY AH M
OFF	AO F
ON	AA N
ON(2)	AO N
ONE	W AH N
ONE(2)	HH W AH N
PINK	P IH NG K
RED	R EH D
THREE	TH R IY
TURN	T ER N
TWO	T UW
UP	AH P
WHITE	W AY T
WHITE(2)	HH W AY T
YELLOW	Y EH L OW
